%%%%%
%...%
%...%
%...%
%P..%
%%%%%