%%%%%%%%%
%       %
% %%%%  %
%       %
%   P   %
%%%%    %
%%%% .G %
%%%%    %
%%%%%%%%%